NO	./textures/redbrick.png
SO	./textures/greystone.png
WE	./textures/bluestone.png

C	225 ,10 ,0
F 020, 255, 1.1
EA	./textures/walkstone.png.png

11111111111111111111111111111111111111111
10000000000000000000000001111111111111111
10000000000000000000000001111111111111111
10000000000000000000000001111111111111111
100000000000000W0000000001111111111111111
10000000000000000000000001111111111111111
10000000000000000000000000000000000000011
10000000000000000000000001111111111111111
10000000000000000000000001111111111111111
11111111111111111111111111111111111111111
10000000000000000000000001111111111111111
10000000000000000000000000000000000000011
10000000000000000000000000000000000000011
10000000000000000000000000000000000000011
10000000000000000000000001111111111111111
10000000000000000000000001111111111111111
10000000000000000000000001111111111111111
11111111111111111111111111111111111111111
