NO	./textures/redbrick.png
SO	./textures/greystone.png
WE	./textures/bluestone.png

C	225 ,10 ,0
F 020, 255, 1.1
EA	./textures/walkstone.png.png

11111111111111111111111111111111111111111
10000000000000000000000000000000000000001
10111100000000000000000000000000000000001
10000000000000000000000000000000000000011111111111111111
10000000000000000000000000000000000000000000010000000001
10000000000000000000000000000000000000000111111111111111
10111100000000000000000000000000000000001
10000000000000000000000000000000000000001
10000000000000000E00000000000000000000001         1
10000010000000000000000000000000000000001
11111110000000000000000000000000000000001
11111111111111111111111111111111111111111
