NO	./textures/door.png
SO	./textures/door.png
WE	./textures/door.png
EA	./textures/door.png


C 0, 125 , 255
F 255, 0, 123

11111111111111111111111111111111111111111
10000000000000000000000000000000000000001
10111100000000000000000000000000000000001
1000000000000000000111111111000000000001111111111111111111
10000000000000000001       10000000000000000000000000000001
1000000000000000000111111111000000000000011111111111111111
10111100000000000000000000000000000000001
10000000000000000000000000000000000000001
10000000000000000E00000000000000000000001         1
10000010000000000000000000000000000000001
11111110000000000000000000000000000000001
11111111111111111111111111111111111111111
