NO ./textures/greystone.png
SO ./textures/purplestone.png
WE ./textures/colorstone.png
EA ./textures/wood.png

C 255,255,125
F  255, 255, 1

11111111
10000011
10N00010
10000011
11111111
