NO ./textures/greystone.png
SO ./textures/purplestone.png
WE ./textures/colorstone.png
EA ./textures/wood.png
F 220,100,0
C 225,10,0

1111111111111111111111111
1000000000000000000000001
1000000000000000000000001
1000000000000000000000001
1000001111100001010100001
1000001000100000000000001
1000001000100001000100001
1000001000100000000000001
1000001101100001010100001
1000000000000000000000001
1000000000000000000000001
1000000000000000000000001
1000000000000000000000001
1000000000000000000000001
1000000000000000000000001
1000000000000000000000001
111111111N000000000000001
1101000010000000000000001
1100001010000000000000001
1101000010000000000000001
1101111110000000000000001
11000000D0000000000000001
1111111110000000000000001
1111111111111111111111111
