NO ./textures/greystone.png
SO ./textures/purplestone.png
WE ./textures/colorstone.png
EA ./textures/wood.png

C 225,10,0
F 255, 255, 1

1111111111111111111111111
1000000011110000000000001
1000000000000000000000001
1000000000000000000000001
1000001111100001010100001
1000001000100000000000001
1000001000100001000100001
1000001000100000000000001
1110001101100001010100001
0010000000000000000000001
1110000000000010000001111
1000000000000010000001001
100000N000000010000000000
1000000000000010000001001
1000000000000010000001111
1000000000000010000000001
1111111110000000000000001
1101000010000000000000001
1100001010000000000000001
1101000010000000000000001
1101111110000 00000000001
1100000000000 00000000001
1111111110000 00000000001
1111111111111 11111111111
