NO ./textures/greystone.png
SO ./textures/purplestone.png
WE ./textures/colorstone.png
EA ./textures/wood.png
F 220,100,0
C 225,10,0

1111111111111111111111111
1000000000000000000000001
1000000000000000000000001
1000000000000000000000001
1000001111100001D1D100001
100000100010000D000D00001
1000001000100001000100001
100000100010000D000D00001
1000001101100001D1D100001
1000000000000000000000001
111111111N000000000000001
1101000010000000000000001
1100001010000000000000001
1101000010000000000000001
11D1111110000000000000001
11000000D0000000000000001
1111111110000000000000001
1111111111111111111111111
