NO	./textures/redbrick.png
SO	./textures/greystone.png
WE	./textures/bluestone.png
EA	./textures/walkstone.png

C 225,10,0
F 255, 255, 1

11111111
10000001
10111101
10000001
100S0001
10000001
10111101
10000001
10000001
10000001
11111111
