NO	./textures/door.png
SO	./textures/door.png
WE	./textures/door.png

C	225 ,10 ,0
F 020, 255, 0
EA	./textures/door.png

11111111
10000001
10111101
10000011
10000001
10000001
100S0001
10000001
10000001
10000010
10000001
10000001
10000001
10000001
10000001
10000001
10000001
10000001
10000001
10000001
10000001
10000001
10000001
10000001
10000001
10000001
10000001
10000001
10000001
10000001
10000001
10000001
10000001
10000001
10000001
10000001
10000001
10000001
10000001
10000001
10000001
10000001
11111111
