NO	./textures/redbrick.png
SO	./textures/greystone.png
WE	./textures/bluestone.png
EA	./textures/walkstone.png
F 220,100,0
C 225,30,0



111111
100101
10W101
111101
111111
